49 49
@ @ @ @ @ @ @ @ @ @ @ @ @ @ @ @ @ @ @ @ @ @ @ @ @ @ @ @ @ @ @ @ @ @ @ @ @ @ @ @ @ @ @ @ @ @ @ @ @
@ @ @ . . . . . . . . . . . . @ @ @ @ . @ @ @ . . . @ @ @ @ . @ @ @ @ . . . . . . . . . . . . @ @
@ @ . . . . . . . . . . . . . @ @ @ . . . . . . . . @ @ @ . . @ @ @ . . . . . . . . . . . . . @ @
@ . . . . . . . . . . . . . . . . . . . . . . . . . . . . . . . . . . . . . . . . . . . . . . . @
@ . . . . . . . . . . . . . . . . . . . . . . . . . . . . . . . . . . . . . . . . . . . . . . . @
@ . . . . . . . . . . . . . . . . . . . . . . . . . . . . . . . . . . . . . . . . . . . . . . . @
@ . . . . . . . . . . . . . . . . . . . . . . . . . . . . . . . . . . . . . . . . . . . . . . . @
@ . . . . . . . . . . . . . . . . . . . . . . . @ @ . . . . . . . . . . . . . . . . . . . . . . @
@ . . . . . . . . . . . . . . . . . . . . . . @ @ @ . . . . . . . . . . . . . . . . . . . . . . @
@ . . . . . . . . . . . . . . . . . . . . . . @ @ @ . . . . . . . . . . . . . . . . . . . . . . @
@ . . . . . . . . . . . . . . . . . . . . . . . . . . . . . . . . . . . . . . . . . . . . . . . @
@ . . . . . . . . . . . . . . . . . . . . . . . . . . . . . . . . . . . . . . . . . . . . . . . @
@ . . . . . . . . . . . . . . . . . . . . . . . . . . . . . . . . . . . . . . . . . . . . . . . @
@ . . . . . . . . . . . . . . . . . . . . . . . . . . . . . . . . . . . . . . . . . . . . . . . @
@ . . . . . . . . . . . . . . . . . . . . . . . . . . . . . . . . . . . . . . . . . . . . . . . @
@ @ @ . . . . . . . . . . . . @ @ @ @ . . . . . . . . . . . . @ @ @ @ . . . . . . . . . . . . @ @
@ @ @ . . . . . . . . . . . . @ @ @ @ . . . . . . . . . . . . @ @ @ @ . . . . . . . . . . . . @ @
@ @ @ . . . . . . . . . . . . @ @ @ @ . . . . . . . . . . . . @ @ @ @ . . . . . . . . . . . . @ @
@ @ . . . . . . . . . . . . . @ @ @ . . . . . . . . . . . . . @ @ @ . . . . . . . . . . . . . @ @
@ @ . . . . . . . . . . . . . . . . . . . . . . . . . . . . . . . . . . . . . . . . . . . . . . @
@ @ . . . . . . . . . . . . . . . . . . . . . . . . . . . . . . . . . . . . . . . . . . . . . . @
@ @ . . . . . . . . . . . . . . . . . . . . . . . . . . . . . . . . . . . . . . . . . . . . . . @
@ @ . . . . . . . . . . . . . . . . . . . . . . . . . . . . . . . . . . . . . . . . . . . . . . @
@ . . . . . . . . . . . . . . . . . . . . . . . . . . . . . . . . . . . . . . . . . . . . . . . @
@ . . . . . . . . . . . . . . . . . . . . . . . . . . . . . . . . . . . . . . . . . . . . . . . @
@ . . . . . . . . . . . . . . . . . . . . . . . . . . . . . . . . . . . . . . . . . . . . . . . @
@ @ . . . . . . . . . . . . . . . . . . . . . . . . . . . . . . . . . . . . . . . . . . . . . . @
@ @ @ . . . . . . . . . . . . . . . . . . . . . . . . . . . . . . . . . . . . . . . . . . . . . @
@ @ @ . . . . . . . . . . . . . . . . . . . . . . . . . . . . . . . . . . . . . . . . . . . . . @
@ @ @ . . . . . . . . . . . . . . . . . . . . . . . . . . . . . . . . . . . . . . . . . . . . . @
@ . . . . . . . . . . . . . . . . . . . . . . . . . . . . . . . . . . . . . . . . . . . . . . . @
@ @ @ . . . . . . . . . . . . @ @ @ @ . . . . . . . . . . . . @ @ @ @ . . . . . . . . . . . . @ @
@ @ @ . . . . . . . . . . . . @ @ @ @ . . . . . . . . . . . . @ @ @ @ . . . . . . . . . . . . @ @
@ @ @ . . . . . . . . . . . . @ @ @ @ . . . . . . . . . . . . @ @ @ @ . . . . . . . . . . . . @ @
@ @ . . . . . . . . . . . . . @ @ @ . . . . . . . . . . . . . @ @ @ . . . . . . . . . . . . . @ @
@ . . . . . . . . . . . . . . . . . . . . . . . . . . . . . . . . . . . . . . . . . . . . . . . @
@ . . . . . . . . . . . . . . . . . . . . . . . . . . . . . . . . . . . . . . . . . . . . . . . @
@ . . . . . . . . . . . . . . . . . . . . . . . . . . . . . . . . . . . . . . . . . . . . . . . @
@ . . . . . . . . . . . . . . . . . . . . . . . . . . . . . . . . . . . . . . . . . . . . . . . @
@ . . . . . . . . . . . . . . . . . . . . . . . . . . . . . . . . . . . . . . . . . . . . . . . @
@ . . . . . . . . . . . . . . . . . . . . . . . . . . . . . . . . . . . . . . . . . . . . . . . @
@ . . . . . . . . . . . . . . . . . . . . . . . . . . . . . . . . . . . . . . . . . . . . . . . @
@ . . . . . . . . . . . . . . . . . . . . . . . . . . . . . . . . . . . . . . . . . . . . . . . @
@ . . . . . . . . . . . . . . . . . . . . . . . . . . . . . . . . . . . . . . . . . . . . . . . @
@ . . . . . . . . . . . . . . . . . . . . . . . . . . . . . . . . . . . . . . . . . . . . . . . @
@ . . . . . . . . . . . . . . . . . . . . . . . . . . . . . . . . . . . . . . . . . . . . . . . @
@ . . . . . . . . . . . . . . . . . . . @ @ @ . . . @ @ @ . . . . . . . . . . . . . . . . . . . @
@ @ @ . . . . . . . . . . . . @ @ @ @ . @ @ @ @ . . @ @ @ @ . @ @ @ @ . . . . . . . . . . . . @ @
@ @ @ @ @ @ @ @ @ @ @ @ @ @ @ @ @ @ @ @ @ @ @ @ @ @ @ @ @ @ @ @ @ @ @ @ @ @ @ @ @ @ @ @ @ @ @ @ @
40
19 26 19 29
44 30 43 28
31 23 33 23
30 22 31 21
40 14 43 16
11 1 13 1
9 40 7 41
12 6 15 4
47 30 44 28
45 46 44 43
20 18 25 16
25 28 21 30
11 9 15 3
18 36 22 40
28 42 24 41
41 14 45 16
25 39 27 43
31 12 26 9
8 27 12 25
41 17 44 14
3 2 10 9
22 22 11 24
32 19 31 11
15 45 7 42
31 28 41 29
31 13 40 8
18 9 13 3
2 14 5 6
13 12 18 6
31 40 23 35
23 18 20 31
24 28 15 20
45 17 34 14
41 10 28 12
42 18 33 30
25 26 22 12
4 34 6 22
14 22 26 13
10 14 20 8
11 35 12 21